CHICKEN	CH IH K AH N
CROWD	K R AW D
DANCE	D AE N S
DANCING	D AE N S IH NG
DEMO	D EH M OW
DISCO	D IH S K OW
DO	D UW
DRUMBING	D R AH M B IY IH NG
EGYPTIAN	IH JH IH P SH AH N
EVERYONE	EH V R IY W AH N
FABRIC	F AE B R IH K
HUBO	HH Y UW B OW
OK	OW K EY
ROBOT	R OW B AA T
ROBOT(2)	R OW B AH T
RUN	R AH N
STOP	S T AA P
THE	DH AH
THE(2)	DH IY
TO	T UW
TO(2)	T IH
TO(3)	T AH
WAVE	W EY V
